Column Name	Description
banca	Identificador del tipo de banca
ctpa	Identificador de la contrapartida asociada a la banca (area_id)
n_cont_CP_m	numero contratos corto plazo de la contrapartida perteneciente a esa banca en el mes (m)
n_cont_LP_m	numero contratos largo plazo de la contrapartida perteneciente a esa banca en el mes (m)
n_cont_Tot_m	numero total de contratos cp + lp de la contrapartida perteneciente a esa banca en el mes (m)
rwas_CP_m	suma de aprs de los contratos de corto plazo de la contrapartida perteneciente a esa banca en el mes (m)
rwas_LP_m	suma de aprs de los contratos de largo plazo de la contrapartida perteneciente a esa banca en el mes (m)
rwas_Tot_m	suma del total de aprs cp + lp de la contrapartida perteneciente a esa banca en el mes (m)
n_cont_CP_m1	numero contratos corto plazo de la contrapartida perteneciente a esa banca en el mes anterior (m1)
n_cont_LP_m1	numero contratos largo plazo de la contrapartida perteneciente a esa banca en el mes anterior (m1)
n_cont_Tot_m1	numero total de contratos cp + lp de la contrapartida perteneciente a esa banca en el mes anterior (m1)
rwas_CP_m1	suma de aprs de los contratos de corto plazo de la contrapartida perteneciente a esa banca en el mes anterior (m1)
rwas_LP_m1	suma de aprs de los contratos de largo plazo de la contrapartida perteneciente a esa banca en el mes anterior (m1)
rwas_Tot_m1	suma del total de aprs cp + lp de la contrapartida perteneciente a esa banca en el mes anterior (m1)
n_cont_CP_diff	diferencia mes actual (m) contra mes anterior (m1) en el numero de contratos de corto plazo de la contrapartida perteneciente a esa banca
n_cont_LP_diff	diferencia mes actual (m) contra mes anterior (m1) en el numero de contratos de largo plazo de la contrapartida perteneciente a esa banca
num_cont_Tot_diff	diferencia total de contratos cp + lp del mes actual (m) contra el mes anterior (m1) para esa contrapartida perteneciente a esa banca
rwas_CP_diff	diferencia mes actual (m) contra mes anterior (m1) en la suma de aprs de contratos de corto plazo de la contrapartida perteneciente a esa banca
rwas_LP_diff	diferencia mes actual (m) contra mes anterior (m1) en la suma de aprs de contratos de largo plazo de la contrapartida perteneciente a esa banca
rwas_Tot_diff	diferencia mes actual (m) contra mes anterior (m1) en la suma de aprs de contratos cp + lp de la contrapartida perteneciente a esa banca
n_cont_CP_SA	numero contratos de corto plazo que salen de la bolsa para la contrapartida perteneciente a esa banca en el mes (m)
n_cont_LP_SA	numero contratos de largo plazo que salen de la bolsa para la contrapartida perteneciente a esa banca en el mes (m)
n_cont_Tot_SA	numero contratos totales cp + lp que salen de la bolsa para la contrapartida perteneciente a esa banca en el mes (m)
rwas_CP_SA	suma de aprs de los contratos de corto plazo que salen de la bolsa para la contrapartida perteneciente a esa banca en el mes (m)
rwas_LP_SA	suma de aprs de los contratos de largo plazo que salen de la bolsa para la contrapartida perteneciente a esa banca en el mes (m)
rwas_Tot_SA	suma del total de aprs cp + lp de los contratos que salen de la bolsa para la contrapartida perteneciente a esa banca en el mes (m)
n_cont_CP_SI_m	numero contratos de corto plazo que entran en la bolsa para la contrapartida perteneciente a esa banca en el mes (m)
n_cont_LP_SI_m	numero contratos de largo plazo que entran en la bolsa para la contrapartida perteneciente a esa banca en el mes (m)
n_cont_Tot_SI_m	numero total de contratos cp + lp que entran en la bolsa para la contrapartida perteneciente a esa banca en el mes (m)
rwas_CP_SI_m	suma de los aprs de los contratos de corto plazo que entran en la bolsa para la contrapartida perteneciente a esa banca en el mes (m)
rwas_LP_SI_m	suma de los aprs de los contratos de largo plazo que entran en la bolsa para la contrapartida perteneciente a esa banca en el mes (m)
rwas_Tot_SI_m	suma total de los aprs cp + lp de los contratos que entran en la bolsa para la contrapartida perteneciente a esa banca en el mes (m)

------------

Column Name	Description
banca	Identificador del tipo de banca
ctpa	Identificador de la contrapartida asociada a la banca (area_id)
rwas_Tot_m	Total de APRs de la contrapartida en la banca asociada en el mes actual (m). Es un agrupado que representa el 100% de los APRs de la contrapartida en la banca asociada.
Grand_Tot_m	Total de APRs mes actual
pct_Grand_Tot_m	Porcentage de APRs que representa la contrapartida asociada a la banca respecto al total de APRs del mes actual (rwas_Total_m/grand_total_m)
rwas_Tot_m1	Total de APRs de la contrapartida en la banca asociada en el mes anterior (m1). Es un agrupado que representa el 100% de los APRs de la contrapartida en la banca asociada.
Grand_Tot_m1	Total de APRs mes anterior
pct_Grand_Tot_m1	Porcentage de APRs que representaba la contrapartida asociada a la banca respecto al total de APRs el mes anterior (rwas_Total_m1/grand_total_m1)
rwas_Tot_diff	Variación neta del total de APRs de la contrapartida en la banca asociada entre el mes actual (m) y el mes anterior (m1). Calculado como: rwas_Total_m - rwas_Total_m1.
pct_var_rwas_MoM	Variación relativa del total de APRs de la contrapartida en la banca asociada entre el mes actual (m) y el mes anterior (m1). Calculado como: (pct_Grand_Tot_m - pct_Grand_Tot_m1)/pct_Grand_Tot_m1
pct_var_GT_MoM	Variación relativa del total de APRs de la contrapartida entre el mes actual (m) y el mes anterior (m1). Calculado como: rwas_Total_diff / rwas_Total_m1.
ctpa_Tot_m	Total neto de APRs que representa esa contrapartida para todas las bancas en mes actual (m)  (sumatorio de la misma contrapartida para todas las bancas)
pct_ctpa_Tot_m	Peso en porcentaje que representa esa contrapartida en esa banca respecto al total de su contrapartida en el mes actual. Calculado como: rwas_Total_m / ctpa_Tot_m.
ctpa_Tot_m1	Total neto de APRs que representa esa contrapartida para todas las bancas en mes anterior(m1)  (sumatorio de la misma contrapartida para todas las bancas)
pct_ctpa_Tot_m1	Peso en porcentaje que representa esa contrapartida en esa banca respecto al total de su contrapartida en el mes anterior. Calculado como: rwas_Total_m1 / ctpa_Tot_m1.
ctpa_Tot_diff	Variación neta del total de APRs del total de contrapartida en el mes(m) respecto al total en mes anterior (m1).
pct_var_ctpa_Tot_MoM	Variación relativa del peso porcentual que representa esa contrapartida entre el mes actual y el anterior.

-------------

Column Name	Description
rorc_cli_m	El RORC (Return on Risk-Weighted Capital) del cliente en esa banca en el mes actual (m).
rorc_cli_m1	El RORC (Return on Risk-Weighted Capital) del cliente en esa banca en el mes anterior (m1).
rorc_cli_var_rel	Variación relativa del RORC del cliente en esa banca en el mes actual (m) vs mes anterior (m1). Calculado como: (rorc_cli_m - rorc_cli_m1) / rorc_cli_m1. Expresa crecimiento o caída proporcional.
rwas_Tot_m	APRs de ese cliente en esa banca en el mes actual (m).
rwas_Tot_m1	APRs de ese cliente en esa banca en el mes anterior (m1).
rwas_Total_diff	Variación neta de APRs de ese cliente en esa banca entre el mes actual (m) y el mes anterior (m1). Calculado como: rwas_Tot_m - rwas_Tot_m1.
pct_rwas_cli_MoM_rel	Variación relativa de APRs de ese cliente en esa banca entre el mes actual (m) y el mes anterior (m1). Calculado como: rwas_Total_diff / rwas_Tot_m1. Expresa crecimiento o caída proporcional.
banca_Grand_Tot_m	Total neto de APRs que representa ese cliente en esa banca en el mes actual respecto al total de APRs de la misma banca.
banca_Grand_Tot_m1	Total neto de APRs que representa ese cliente en esa banca en el mes anterior respecto al total de APRs de la misma banca.
pct_cli_banca_m	Peso en porcentaje de APRs que representa ese cliente en esa banca en el mes actual respecto al total de APRs de la misma banca. Calculado como: rwas_Tot_m / banca_Grand_Tot_m.
pct_cli_banca_m1	Peso en porcentaje de APRs que representa ese cliente en esa banca en el mes anterior respecto al total de APRs de la misma banca. Calculado como: rwas_Tot_m / banca_Grand_Tot_m1.
pct_cli_banca_var_rel	Variación relativa del peso porcentual que representa ese cliente en esa banca entre el mes actual y el mes anterior. Calculado como: (pct_cli_banca_m / pct_cli_banca_m1) - 1. Muestra el cambio proporcional de su contribución.

---------

Column Name	Description
rwas_Tot_m	APRs de esa contrapartida (ctpa) de ese cliente en el mes m
rwas_ctpa_Tot_m	Total de APRs de esa contrapartida (ctpa) en el mes m (valores globales de la contrapartida, no por cliente ni banca)
pct_ctpa_Tot_m	Esa contrapartida de ese cliente representa un X% del total de APRs de esa contrapartida (ctpa) en el mes m
rwas_Tot_m1	APRs de esa contrapartida (ctpa) de ese cliente en el mes m-1
rwas_ctpa_Tot_m1	Total de APRs de esa contrapartida (ctpa) en el mes m-1 (valores globales de la contrapartida, no por cliente ni banca)
pct_ctpa_Tot_m1	Esa contrapartida de ese cliente representa un X% del total de APRs de esa contrapartida (ctpa) en el mes m-1
rwas_Tot_diff	Variación neta de APRs de esa contrapartida (ctpa) de ese cliente entre el mes m y m-1
pct_ctpa_MOM_rel	Variación relativa en porcentaje de esa contrapartida (ctpa) de ese cliente entre el mes m y m-1
pct_rwas_ctpa_MOM_rel	Variación relativa en porcentaje del peso que representa esa contrapartida (ctpa) de ese cliente respecto al total de APRs de esa contrapartida entre el mes m y m-1
rwas_cliente_Tot_m	Total de APRs de ese cliente en el mes m (valores globales del cliente, no por contrapartida ni banca)
pct_ctpa_cli_m	Esa contrapartida (ctpa) de ese cliente representa un X% del total de APRs de ese cliente en el mes m
rwas_cliente_total_m1	Total de APRs de ese cliente en el mes m-1 (valores globales del cliente, no por contrapartida ni banca)
pct_ctpa_cli_m1	Esa contrapartida (ctpa) de ese cliente representa un X% del total de APRs de ese cliente en el mes m-1
pct_ctpa_cli_var_rel	Variación relativa en porcentaje del peso que representa esa contrapartida (ctpa) de ese cliente respecto al total de APRs de ese cliente entre el mes m y m-1
